7 10
__________
0000000000
0____0____
0____0____
_0__0_____
__00______
___0______